1111111111111111111111100000000000000000000110000000000000000000011000000000000000000001100000000000000000000110000000000000000000011000000000000000000001100000000000000000000110000000000000000000011000000000000000000001100000000000000000000110000000000000000000011000000000000000000001100000000000000000000110000000000000000000011000000000000000000001100000000000000000000110000000000000000000011000000000000000000001100000000000000000000110000000000000000000011111111111111111111111
1111111111111111111111100000000000000000000110000000000001111111111000000000000000000001100000000000011111111110000000000000000000011000000000000111111111100000000000000000000110000000000001111111111000000000000000000001100000000000000000000110000000000000000000011000000000000000000001100000000000000000000110000000000000000000011000000000000000000001100000000000000000000110000000000000000000011000000000000000000001100000000000000000000110000000000000000000011111111111111111111111
1111111111111111111111100000000000000000000110000000000000000000011000000000000000000001100000000000011111111110000000000001111111111000000000000111111111100000000000011111111110000000000000000000011000000000000000000001100000000000000000000110000000000000000000011000000000000000000001100000000000000000000110000000000000000000011000000000000000000001100000000000000000000110000000000000000000011000000000000000000001100000000000000000000110000000000000000000011111111111111111111111
1111111111111111111111100000000000000000000110000000000000000000011000000000000111111111100000000000011111111110000000000000000000011000000000000000000001100000000000011111111110000000000001111111111000000000000000000001100000000000000000000110000000000000000000011000000000000000000001100000000000000000000110000000000000000000011000000000000000000001100000000000000000000110000000000000000000011000000000000111111111100000000000000000000110000000000000000000011111111111111111111111
1111111111111111111111100000000000000000000110000000000000000000011000000000000000000001100011111100000000000110001000010000000000011000100001000000000001100010000100000000000110001000010000000000011000100001000000000001100010000100000000000110000000000000000000011000000000000000000001100000000000000000000110000000000000000000011000000000000000000001100000000000000000000110000000000000000000011000000000000000000001100000000000000000000110000000000000000000011111111111111111111111






{1, 1, 1, 1, 1, 1, 1, 1, 1, 1, 1, 1, 1, 1, 1, 1, 1, 1, 1, 1, 1, 1},
{1, 0, 0, 0, 0, 0, 0, 0, 0, 0, 0, 0, 0, 0, 0, 0, 0, 0, 0, 0, 0, 1},
{1, 0, 0, 0, 0, 0, 0, 0, 0, 0, 0, 0, 0, 0, 0, 0, 0, 0, 0, 0, 0, 1},
{1, 0, 0, 0, 0, 0, 0, 0, 0, 0, 0, 0, 0, 0, 0, 0, 0, 0, 0, 0, 0, 1},
{1, 0, 0, 0, 0, 0, 0, 0, 0, 0, 0, 0, 0, 1, 1, 1, 1, 1, 1, 1, 1, 1},
{1, 0, 0, 0, 0, 0, 0, 0, 0, 0, 0, 0, 0, 1, 1, 1, 1, 1, 1, 1, 1, 1},
{1, 0, 0, 0, 0, 0, 0, 0, 0, 0, 0, 0, 0, 1, 1, 1, 1, 1, 1, 1, 1, 1},
{1, 0, 0, 0, 0, 0, 0, 0, 0, 0, 0, 0, 0, 1, 1, 1, 1, 1, 1, 1, 1, 1},
{1, 0, 0, 0, 0, 0, 0, 0, 0, 0, 0, 0, 0, 0, 0, 0, 0, 0, 0, 0, 0, 1},
{1, 0, 0, 0, 0, 0, 0, 0, 0, 0, 0, 0, 0, 0, 0, 0, 0, 0, 0, 0, 0, 1},
{1, 0, 0, 0, 0, 0, 0, 0, 0, 0, 0, 0, 0, 0, 0, 0, 0, 0, 0, 0, 0, 1},
{1, 0, 0, 0, 0, 0, 0, 0, 0, 0, 0, 0, 0, 0, 0, 0, 0, 0, 0, 0, 0, 1},
{1, 0, 0, 0, 0, 0, 0, 0, 0, 0, 0, 0, 0, 0, 0, 0, 0, 0, 0, 0, 0, 1},
{1, 0, 0, 0, 0, 0, 0, 0, 0, 0, 0, 0, 0, 0, 0, 0, 0, 0, 0, 0, 0, 1},
{1, 0, 0, 0, 0, 0, 0, 0, 0, 0, 0, 0, 0, 0, 0, 0, 0, 0, 0, 0, 0, 1},
{1, 0, 0, 0, 0, 0, 0, 0, 0, 0, 0, 0, 0, 0, 0, 0, 0, 0, 0, 0, 0, 1},
{1, 0, 0, 0, 0, 0, 0, 0, 0, 0, 0, 0, 0, 0, 0, 0, 0, 0, 0, 0, 0, 1},
{1, 0, 0, 0, 0, 0, 0, 0, 0, 0, 0, 0, 0, 0, 0, 0, 0, 0, 0, 0, 0, 1},
{1, 0, 0, 0, 0, 0, 0, 0, 0, 0, 0, 0, 0, 0, 0, 0, 0, 0, 0, 0, 0, 1},
{1, 0, 0, 0, 0, 0, 0, 0, 0, 0, 0, 0, 0, 0, 0, 0, 0, 0, 0, 0, 0, 1},
{1, 0, 0, 0, 0, 0, 0, 0, 0, 0, 0, 0, 0, 0, 0, 0, 0, 0, 0, 0, 0, 1},
{1, 1, 1, 1, 1, 1, 1, 1, 1, 1, 1, 1, 1, 1, 1, 1, 1, 1, 1, 1, 1, 1},
